1 15 6046 1187 3423 6077 2000 1643 293 6065 666 5427 1747 3373 5152 6034 2094 
1 12 2094 6071 2958 4538 6250 59 6334 3768 6435 6489 4741 4463 
1 10 6472 2573 2051 6380 6343 3500 4326 4921 4868 2471 
1 13 3775 1681 6674 6673 4972 3816 6635 5358 6549 1029 6527 6495 6472 
1 17 6046 776 68 6070 4969 5431 4263 3276 4899 6405 3844 3146 6463 6445 6411 6439 6472 
1 22 6046 6007 2943 5976 5964 4138 5938 70 5915 1731 5937 4856 750 5879 5910 192 5963 830 4611 1172 6105 2471 
1 18 2471 1058 6190 6225 1369 3075 2406 6409 4749 3780 6553 5394 3721 6599 6578 6564 1125 6472 
1 11 2406 6349 6340 3702 4763 6462 6513 3 6610 2430 3198 
1 7 3198 2527 6681 6659 2898 6646 5394 
1 12 1125 6582 1327 2257 1855 6812 4967 281 6977 7026 7049 7080 
1 11 3198 6759 3193 2083 5583 6740 6705 6710 6663 1598 1327 
1 3 6646 1899 6705 
1 12 7049 4562 4398 4109 164 4718 6924 6899 299 6804 571 3198 
1 13 5963 6002 6010 4148 6110 2201 4675 6193 6227 6240 3162 6307 4899 
1 7 3775 1014 1196 1490 2508 6986 4564 
1 13 7080 7068 7028 7021 3028 6985 1700 6904 6871 6829 6793 2642 3775 
1 8 6985 3464 6998 1355 6980 6955 2737 1490 
1 8 6527 4613 3252 6751 6784 2717 6963 3028 
1 11 4279 6442 6391 6345 6304 2626 6206 694 6115 6089 6046 
1 11 3775 514 6550 6502 6488 6467 1119 6464 6450 820 4279 
1 9 4279 6500 5393 3827 5207 263 528 6305 59 
1 14 4564 7009 391 6952 6974 6933 6916 5491 6893 4068 6837 805 6818 4087 
1 16 4463 463 6685 4995 4087 418 453 7029 7069 3120 7186 491 7295 5291 5169 7376 
1 21 4463 6589 1540 6602 3645 6647 2004 6656 4878 1012 87 6676 6664 381 2576 6567 5188 187 6461 4884 1279 
1 21 2094 14 1325 3572 4937 3728 4185 6359 755 137 6373 1848 2322 1113 6365 26 5340 1760 2772 5241 1279 
1 9 7080 4391 7170 2059 7294 4653 2982 7366 7341 
1 10 2982 4784 3202 7492 7529 2053 1153 7668 7720 7767 
1 12 7767 7806 7824 2483 1909 7881 1890 96 7721 7669 1965 4104 
1 12 7080 7120 7159 7185 7233 5244 5356 3569 1830 7481 7461 4104 
1 8 7080 4254 7104 4720 7225 5278 7303 7341 
1 20 7767 4860 7811 4302 2497 7818 4040 7896 898 3113 4740 7717 1911 2781 5239 7560 4282 2292 7411 7366 
1 8 7881 1758 3123 5127 8133 8179 1331 8262 
1 12 4302 5249 7943 1388 8053 669 8159 1150 4903 8306 2985 8262 
1 17 5154 3429 9332 4260 180 9194 9157 1542 9187 2849 510 9225 1123 9206 5272 9205 822 
1 14 2849 9128 3866 9002 8903 1015 8818 8773 8723 2679 8716 8684 8705 8661 
1 11 9332 1305 4537 689 1733 761 9654 1525 4598 9752 1726 
1 8 4598 9778 4199 2680 9919 9949 405 9991 
1 43 5154 9223 9188 9158 5111 9069 1170 8962 8929 8876 4883 794 1814 652 3600 154 3328 4364 5366 8226 1836 8148 1816 1121 7976 3698 2682 7816 4591 7783 4874 7820 7871 1462 7827 7876 1967 367 1625 3227 4758 2493 8359 
1 10 8661 1892 8560 4264 8449 2096 8353 1078 3832 8359 
1 29 8359 4577 138 1468 8635 8688 8715 4648 3221 8858 4209 9005 4585 9086 9108 4691 9250 5523 3722 9442 1260 9518 9537 1226 3492 2516 9669 9709 9727 
1 9 822 9180 9153 1762 2583 9251 5196 3892 5523 
1 14 9727 3137 3584 5261 803 9924 9958 9990 1080 10112 5395 4054 2702 10216 
1 20 938 896 90 10378 1473 438 10418 2107 1791 723 1672 3752 10433 936 4216 10403 10392 159 1223 10321 
1 9 938 10235 778 4379 337 4236 10285 3936 10321 
1 28 938 3127 2373 10300 10290 3797 2311 506 10323 23 3025 10264 3489 10226 627 10205 2957 2245 10171 5173 3044 4505 5589 10135 1133 867 304 337 
1 20 10321 912 3946 2015 10230 3592 106 1755 2357 10040 5038 349 499 10024 3993 9973 2437 9959 2235 9919 
1 24 1080 1358 930 10177 1027 3385 2671 3327 2474 1491 3623 10390 2229 4288 5535 591 1886 10385 10364 1971 2597 10282 3814 10216 
1 14 1971 511 4638 1201 10334 2424 10352 3308 10388 4663 3537 3643 3365 10337 
1 25 4638 10259 10240 2241 10220 10244 1225 4039 10223 10237 748 10260 1441 10292 2169 10336 5087 10346 2355 4058 10339 10356 3580 10347 159 
1 5 10337 10326 852 10284 10260 
1 18 9991 1347 1465 3325 9876 306 5103 752 5325 4193 5354 9570 9504 4621 3873 2375 2513 5272 
1 9 1726 9779 4545 4513 853 2701 9953 3038 10040 
1 11 5633 3952 5237 4038 5639 1939 5659 344 3108 518 5700 
1 18 5633 5631 4370 2951 5146 1555 307 1457 5698 5708 6 5731 5746 3245 5772 5791 5816 81 
1 33 150 4669 1614 2349 222 3008 4646 5838 1798 5788 5564 2150 3507 4096 681 2024 1934 1621 5744 5732 2404 4233 4935 4099 564 5720 909 1398 4498 5702 3630 5355 5700 
1 15 5744 2909 5766 1833 3186 2454 5919 647 5999 451 6090 6099 6137 6172 2092 
1 18 2092 6171 757 4895 6043 2759 5982 1294 2867 4641 5917 1982 2157 5898 4911 5870 4158 81 
1 5 344 5676 5683 781 5702 
1 32 6172 6165 4846 3102 6243 988 6301 4332 2172 6327 6346 6351 2988 6273 6267 3853 6287 1849 4875 733 6231 3312 2277 2081 6245 5319 6239 3913 1562 6159 1275 150 
1 37 2094 5989 4816 5965 5949 414 1787 298 5867 4328 4637 5845 5855 128 3399 1610 5876 2937 1108 2910 596 5925 5944 5969 643 3736 5994 2706 845 3581 5890 878 5903 5873 3920 5848 81 
1 11 1279 2010 6284 86 4459 62 5408 6102 6063 916 643 
1 17 1279 1750 1871 6311 3785 6320 6321 4803 2912 6371 5557 4845 636 2369 6666 1725 2498 
1 12 5903 1800 3558 1841 6097 1645 6221 6254 4636 91 589 4845 
1 23 2498 6744 6728 5084 97 2631 3826 6481 6430 2388 6300 6268 3144 6168 6129 6080 1724 5978 1940 618 5881 2954 81 
1 14 4564 3501 5297 7113 2488 7196 7251 4563 7310 7349 7355 4923 7451 7461 
1 14 1331 4506 3294 5372 8263 8227 71 5157 5432 8264 5457 4466 3764 8050 
1 15 8050 319 7995 7944 7917 4334 7877 7829 7797 3064 7676 4494 7606 7591 4104 
1 22 8050 760 1832 4256 2863 7867 7812 5316 774 7688 1501 7652 3515 4713 7496 7502 1938 7412 1740 7425 2933 7376 
1 7 2933 5300 3860 4861 7592 5234 4399 
1 23 4399 7752 7768 7758 7738 7689 230 4998 728 699 7466 7416 1495 3950 1968 283 7201 3849 7134 7093 2818 2594 1766 
1 8 1766 6874 3609 6770 4693 1605 6584 5188 
1 6 5432 4828 3591 8550 8643 3919 
1 12 3919 8747 1145 2098 1581 8626 1217 8469 8421 8366 5178 4466 
1 10 1217 8577 8583 3066 8543 8527 3112 2200 8556 8499 
1 19 8499 4981 8399 1220 2011 1548 3761 8302 4569 8276 8238 1179 2394 895 2570 2385 1193 7786 7738 
1 13 3849 7188 3324 7213 7202 7207 2118 7208 7270 7278 2291 7285 4468 
1 14 4468 7246 7203 7126 4727 879 7031 6982 6940 6892 6865 2468 5099 2498 
1 15 2098 8689 8724 8768 1900 8774 2384 8819 5504 1810 3583 5212 4227 5382 8963 
1 12 5212 9024 3998 9129 9175 9219 3486 9313 2950 4814 9480 934 
1 19 934 9575 9595 4491 2971 1989 9670 2254 1028 9558 3247 9472 3531 73 9398 4075 9355 4642 4546 
1 15 9398 9427 3838 9485 9506 9520 1378 4019 1718 2922 9597 9628 1448 889 9700 
1 17 4546 9215 9176 9130 3557 9027 3774 2973 3427 8755 1129 4959 2117 2524 4933 4346 8292 
1 12 8292 1653 8160 4218 4987 7983 7924 3356 7777 7731 4479 4986 
1 10 4986 7533 7477 7445 1178 2641 2839 7371 5148 7285 
1 14 9700 5230 103 9713 4777 4785 9760 623 4557 9749 477 4480 9661 3413 
1 17 3557 4101 3088 2568 8979 8994 8980 8968 8945 3121 3887 415 8837 5533 8769 8776 2541 
1 15 3413 550 9582 3690 3854 638 2284 339 1690 9102 1324 8998 8914 3125 2541 
1 10 1324 8999 8924 8909 3904 8811 8743 4526 5398 562 
1 14 562 8537 8473 8400 8356 5318 3686 8194 784 8064 4274 1395 4722 5128 
1 18 4986 98 7739 7759 7808 5416 7935 1924 8000 7993 3922 8046 4754 7984 3390 2473 4436 5128 
1 15 5128 7753 2115 7622 421 2554 7393 7338 424 2287 1432 1167 5329 1553 2468 
1 22 9493 4149 9425 9391 992 9424 9439 5413 4048 9321 657 9257 5225 4375 4493 9238 4851 4704 9208 4152 5068 577 
1 14 992 3691 9258 5305 3454 4571 167 2978 8985 3240 8850 8803 3891 3432 
1 11 562 4127 8508 8444 8422 4030 1020 8345 8286 1942 8244 
1 19 8244 996 3855 3749 8307 1668 402 1242 1126 8427 8494 1502 8495 3266 8627 348 4272 4590 3432 
1 11 216 766 4373 9964 10002 5562 3022 10089 4695 4666 3397 
1 7 216 9944 3469 151 10012 10041 10064 
1 19 10064 549 10161 10176 10185 982 2993 4188 10355 4737 585 631 2234 1122 10423 4892 2935 5418 5120 
1 23 5120 5203 10380 10400 2855 191 5135 10393 3009 642 4511 10342 392 10350 10330 672 622 10262 10227 3132 2174 10153 2082 
1 14 4472 2485 3694 155 2414 10032 10020 4850 3960 2664 670 10098 10118 2082 
1 15 4472 1512 2006 3305 322 5344 2264 658 2060 4402 1530 10029 10072 944 10064 
1 17 216 5488 9857 1744 2776 3510 9746 9719 9688 9645 1549 3864 3712 1732 1397 9364 5588 
1 27 3432 269 442 8796 2845 8797 8844 4347 8902 3242 9019 9072 1087 9166 2422 9270 1536 3000 9394 807 814 9573 9613 4196 4919 1132 9719 
1 18 3242 2652 8949 5377 3368 5567 8880 4126 365 656 8784 1306 1214 5011 4006 8641 2647 8559 
1 17 8244 8200 2836 5089 8016 7954 1671 5483 7789 3487 487 7602 952 7498 3869 2354 7379 
1 23 7379 1703 4913 7173 7129 2056 7023 6983 6929 6877 5031 232 2253 6689 3087 2929 6604 6590 2914 6561 351 4425 3826 
1 11 2092 3380 5217 4680 2039 6375 4295 3079 6547 64 3087 
1 15 6809 445 2605 911 1100 1811 6826 3801 724 490 3272 2446 1403 6718 232 
1 19 7379 7339 7324 7340 7312 4129 7272 1005 7168 3997 4508 1377 1509 6993 6984 3099 6954 190 445 
1 13 4590 1957 3421 8474 2054 8380 5555 8384 8340 5391 5003 1641 4502 
1 13 8559 8547 8520 8476 890 5430 1417 3794 8321 3729 8254 115 4502 
1 15 6809 6835 4361 1320 3205 6948 4676 2300 7024 7046 3979 4197 2793 7079 7111 
1 11 7111 5568 200 4917 7232 7274 5242 7364 7405 7457 7490 
1 20 7111 2779 2040 901 674 7423 4961 7559 7588 1551 3831 7803 472 4857 8027 8084 8141 2296 8210 4502 
1 13 7490 7542 5472 88 3741 82 1564 7967 1976 3203 2564 2519 8380 
1 18 7272 662 5159 7325 7326 343 2086 1298 3634 2462 1247 7623 163 35 7633 775 7686 82 
1 14 4875 461 6403 148 6510 176 1768 5035 6708 3441 4137 4657 4232 3979 
1 10 2082 10101 5455 10010 9979 9954 2258 5048 1616 9749 
1 5 1934 5733 5266 3986 5713 
1 3 4935 563 2460 
1 10 909 22 2556 5685 3182 257 4083 5682 52 5668 
1 5 5668 5660 5650 29 4565 
1 2 733 6269 
1 3 4718 4337 7025 
1 3 5879 5847 5813 
1 3 666 5992 5952 
1 2 1610 718 
1 9 5772 4001 3483 5735 1663 1658 5724 3851 5722 
1 4 4370 1356 5623 5615 
1 2 7225 7192 
1 3 7896 7907 1479 
1 5 4506 1910 8365 3051 2079 
1 3 8365 8309 8262 
1 4 8768 8792 8852 4106 
1 9 4106 8972 9017 9047 5123 3599 9174 3210 9159 
1 3 9129 3556 9112 
1 13 934 9546 2019 2550 9680 2704 9796 3408 2907 9923 3540 1685 4766 
1 10 1685 10028 1498 4944 10104 2769 4630 10129 1136 5573 
1 2 10418 4008 
1 2 4058 3662 
1 10 10336 3343 1858 1765 10419 1180 4363 10440 10444 697 
1 2 1971 10349 
1 4 2357 10075 3503 10018 
1 4 4545 9764 9725 9690 
1 3 1170 5134 2963 
1 5 1226 9606 1589 1678 541 
1 2 1468 4423 
1 3 9520 9561 1378 
1 6 9700 4847 386 9843 9870 9911 
1 13 8776 8726 8677 729 8534 3875 8329 8281 8228 2259 8182 8130 784 
1 13 2287 291 1277 5163 2848 7162 7128 4979 5063 1897 4325 3301 4913 
1 17 8677 4094 5139 3173 1544 8552 380 8528 3341 8481 989 678 8386 4866 3275 8348 8292 
1 11 577 181 9271 9295 9346 2709 3165 9547 363 550 3413 
1 3 10101 650 10085 
1 4 4892 10422 4085 10437 
1 6 10437 1089 2120 5115 4469 10452 
1 5 766 2103 10033 1554 3455 
1 2 766 4825 
1 3 151 10061 10107 
1 2 4695 10073 
1 3 9719 730 2346 
1 7 8559 8456 8412 3544 8352 8322 4690 
1 9 4690 8291 8235 8236 8294 574 4290 4154 4639 
1 8 4961 4301 4449 7569 548 162 660 7589 
1 4 7079 7044 1266 6944 
